1111111111
1000001111
1000000001
1000000111
1111111111