1111111111111
1C10000000P01
1000000000001
100011E1000C1
1111111111111
