1111111111111
1C10000000001
1000000000001
1P0011E0000C1
1111111111111
