1111111111
1P00001111
1000000C01
10C000E111
1111111111